8 9
#########
#...#...#
#..bb.b.#
#...#w#.#
#...++++#
#...#..##
#########
ULRURDDDUULLDDD
6 7
#######
#..####
#.+.+.#
#.bb#w#
##....#
#######
DLLUDLULUURDRDDLUDRR
0 0